111111111111111111111
100000000000000000001
100000000001111110001
1P0000011111111000001
100001111111C00000001
100000000111111111001
1000000000000000001E1
111111111111111111111
