111111
100001
100011
1P0001
1C00E1
111111
