111111
100001
100011
1P0001
1000E1
111111
