111111
1000C1
10P011
100001
1C0001
111111
