111111
1mmmC1
1mPm11
1mmmm1
1Cmmm1
111111
