111111
1000C1
100011
100001
1C00E1
111111
