111111
1000C1
100011
1E0001
1C0PE1
111111
